IIIIIIIIIIIIIIIIIIIIIIIIIIIIIIIIIIIIIIIIIIIIIIIIIIIIIIIIIIIIIIIIIIIIIIIIIIIIIIIIIIIIIIIIIIIIIIIIIIIIIIIIIIIIIIIIIIIIIIIIIIIIIIIIIIIIIIIIIIIIIIIIIIIII
IIIIIIIIIIIIIIIIIIIIIIIIIIIIIIIIIIIIIIIIIIIIIIIIIIIIIIIIIIIIIIIIIIIIIIIIIIIIIIIIIIIIIIIIIIIIIIIIIIIIIIIIIIIIIIIIIIIIIIIIIIIIIIIIIIIIIIIIIIIIIIII E II
IIIIIII                         *                                           *                                             *                        II
IIIIIIII*IIIIIIIIIIIIIIIIIIIIIIIIIIIIIIIIIIIIIIIIIIIIIIIIIIIIIIIIIIIIIIIIIIIIIIIIIIIIIIIIIIIIIIIIIIIIIIIIIIIIIIIIIIIIIIIIIIIIIIIIIIIIIIIIIIIIIIIIIIII
IIIIII *B I            I                I                   I                          I                              I                            II
IIIIII I IIIII IIIIIIIIIIIIIIIII IIIIIIIIIIIIIIIIII IIIIIIIIIIIIIIIIIIIIIIIII IIIIIIIIIIIIIIIIIIIIII IIIIIIIIIIIIIIIIIIIIIIIIIII IIIIIIII IIIIIIIIIII
IIIIII I               I                     I                       I                     I            I                                          II
IIIIII IIIIIII IIIIIIIIIIIIIIIII IIIIIIIIIIIIIIIIII IIIIIIIIIIIIIIIIIIIIIIIII IIIIIIIIIIIIIIIIIIIIII IIIIIIIII IIIIIIIII IIIIIIIIIIII IIIIIIIIIIIIIII
IIIIII  I                                                                   I                                             I                        II
IIIIIII IIIIIIIIIIIIIIIIIIIIIIII IIIIIIIIIIIIIIIIIIIIIIIIIIIIIIIIIIIIIIIIIIII IIIIIIIIII IIIIIIIIIIIIIIIIIIIIIIIIIIIIIIIIII IIIIIIIIIIIIIIIIIIIIIIIII
IIIII   IIIIII IIIIIIIIIIIIIIIII IIIIIIIIIIIIIIIIII IIIIIIIIIIIIIIIIIIIIIIIII IIIIIIIIII IIIIIIIIIII IIIIIIIIIIIIIIIIIIIIII IIIIIIIIIIIIIII IIIIIIIII
IIIII III              I                I                  *I*                         I                              I                            II
IIIII IIIIIIII IIIIIIIII IIIIIIIIIIIIIIIIIIIIIIIIII IIIIIIIIIIIIIIIIIIIIIIIII IIIIIIIIIIIIIIIIIIIIII IIIIIIIIIIIIIIIIIIIIIIIIIII IIIIIIII IIIIIIIIIII
IIIII I II             I                     I                       I                     I            I                        I                 II
IIIII IIIIIIIIIIIIIIIIIIIIIIIIII IIIIIIIIIIIIIIIIII IIIIIIIIIIIIIIIIIIIIIIIIIIIIIIIIIIIIIIIIIIIIIIII IIIIIIIII IIIIIIIII IIIIIIIIIIII IIIIIIIIIIIIIII
IIIII     II                                                                                                 I                      I              II
IIIIIII IIIIIIIIIIIIIIIIIIIIIIIIIIIIIIIIIIIIIIIIIIIIIIIIIIIIIIIIIIIIIIIIIII IIIIIIIIIIIIIIIIIIIIIIIIIIIIIIIIII IIIIIIIIIIIIIIIIIIIIIIII IIIIIIIIIIIII
IIIIIII IIIIIIIIIIIIIIIIIIIIIIIIIIIIIIIIIIIIIIIIIIIIIIIIIIIIIIIIIII                    IIIII          IIIIIIII*IIIIIII    IIIIIII     I IIIIIIIIIIIII
IIIIIII IIIIIIIIIIIIIIIIIIIIIIIIIIIIIIIIIIIIIIIIIIIIIIIIII        IIIIIIIII IIIIIIIIII IIIII IIII*III IIIII  *B IIIIII II     III III I           *II
IIIIIII IIIIIIIIIIIIIIIIIIIIIIIIIIIIIIIIIIIIIIIIIIIIIIIIIIIIIIII IIIII      I*     III III IIIIIIIIII IIIII  I*IIII II IIIIII   I II  I IIIIIIIIIIIII
IIIIIII I                                                              II P IIIIII III    B           IIIIII I IIII II IIIIIIII I II II IIIIIIIIIIIII
IIIIIII IIIIIIIIIIIIIIIIIIIIIIIIIII IIIIIIIIIIIIIIIIIII IIIIIIIIIII II II          IIIIIII IIIIIIIIIIIIIIIII I III     III IIII I II II IIIIIIIOIIIII
IIIIIII I                           II IIIIIIIIIIIIIIII IIIII       II IIIIIIII I   IIIIII IIIIIIIIIIIIIIIII I III III     IIII I II II IIIIIII IIIII
IIIIIII IIIIIIIIIIIIII IIIIIIIIIIIIIII IIIIIIIIIIIIIIII I     III II III  IIIII I    IIIII IIIIIIIIIIIIIIIII       IIIIIIIIIIII   II    IIIIIII IIIII
IIIIIII IIIIIIIIIIIIII IIIIIIIIIIIIIII IIIIIIIIIIIIIIII IIIIIIIII II IIII IIIIIII IIIIIIII IIIIIIIIIIIIIIIIIIIIIIIIIIIIIIIIIIIIIIIIIIII IIIIIII IIIII
IIIIIII I            I                                                                                                                             II
IIIIIII IIIIIIIII IIIIIIIIIIIIIIII IIIIIIIIIIII IIIIIIIIIIII IIIIIII IIIIIII IIII IIIIIIIIIIIIIII IIIIIIIIIIIIIII IIIIIIIIIIIIIII IIIIIIIIII IIIIIIII
IIIIIII I                 I              I           I                                   I                             I                           II
IIIIIII IIIIIIIII IIIIIIIIIIIIIIII IIIIIIIIIIII IIIIIIIIIIII IIIIIII IIIIIII IIII IIIIIIIIIIIIIII IIIIIIIIIIIIIII IIIIIIIIIIIIIII IIIIIIIIII IIIIIIII
IIIIIII IIIIIIIII IIIIIIIIIIIIIIII IIIIIIIIIIII IIIIII*IIIII IIIIIII IIIIIII IIII IIIIIIIIIIIIIII IIIIIIIIIIIIIII IIIIIIIIIIIIIII IIIIIIIIII IIIIIIII
IIIIIII I                 I              I                      I                           I                              I                       II
IIIIIII IIIIIIIII         IIIIIIII IIIIIIIIIIII IIIIIIIIIIII IIIIIII IIIIIII IIII IIIIIIIIIIIIIII IIIIIIIIIIIIIII IIIIIIIIIIIIIII IIIIIIIIIIIIIIIIIII
IIIIIII IIIIIIIII IIIIIIIIIIIIIIII IIIIIIIIIIII IIIIIIIIIIII IIIIIII IIIIIII IIII IIIIIIIIIIIIIII IIIIIIIIIIIIIII IIIIIIIIIIIIIII IIIIIIIIIIIIIIIIIII
IIIIIII I      I                                                                                                                                   II
IIIIIII IIIIIII IIIIIIIIIIIIIIIIIIII IIIIIIIIIII IIIIIIIIIIIIIIIIIIIIII IIIIIIIII IIIIIIII IIIIIIIII IIIIIIIIII II IIIIIIIIIIIIII III IIIIIIIIIIII II
IIIIIII    II                                                           I         I      I           I        I II II     IIIIIII III IIIIIIIIIIII II
IIIIIII I I IIIBIIIIIIIIIIIIIIIIIIIIIIIIIIIIIIIIIIIII IIIIIIIII I IIIII I IIIIIII I IIIIII IIIIIIIIIII IIIIII I II II III II                     I II
IIIIIII I I III   IIIIIIIIO                     I      IIIIII I I II*II I I     I I I IIII I           IIIIII IIII II III II II III I III IIIIIIII II
IIIIIII     *   I IIIIIIIIIIIIIIIIIIIIIIIIIIIII IIIIIIB*IIIII   I       I   IIIII   I      IIIIIIIIIIIII           II   I    II III I III    *     II
IIIIIIIIIIIIIIIII                               *           IIIIIIIIIIIIIIIII   IIIIIIIIIIIIIIIIIIIIIIII IIIIIIIIIIIIIIIIIIIIIIIIIIIIIIIIIIIIIIIIIIII
IIIIIIIIIIIIIIIIIIIIIIIIIIIIIIIIIIIIIIIIIIIIIIIIIIIIIIIIIII                   I                          IIIIIIIIIIIIIIIIIIIIIIIIIIIIIIIIIIIIIIIIIIII
IIIIIIIIIIIIIIIIIIIIIIIIIIIIIIIIIIIIIIIIIIIIIIIIIIIIIIIIIIIIIIIIIIIIIIIIIIIIIIIIIIIIIIIIIIIIIIIIIIIIIIIIIIIIIIIIIIIIIIIIIIIIIIIIIIIIIIIIIIIIIIIIIIIII